111111111111111111111
122222222222222222221
123333333333333333321
123444444444444444321
123440444444440444321
123444444444444444321
123444444444444444321
123444444444444444321
123444444444440444321
123440444444444444321
123444444444444444321
123444444444444404321
123444044444444444321
123444444444444444321
123444044444440444321
123444444444444444321
123444444444444444321
123444444444444444321
123333333444333333321
122222222444222222221
111111111444111111111
