1101101111
1110110111
1011101011
1011101110
1110111101
1011110111
1101111110
1111110111
1110111111
1011111111
